1111111111111111111
1000001000000001001
1001111001001001001
1001000001001000001
1001001001111111111
1001001000000000001
1001001111111111001
1001000000001001001
1001111111001001001
1000001000001001001
1111001001111001001
10000X0001000000001
1111111111111111111
